*****XX***
XXXX*XXXXX
*X*X**X***
*X**X*XXXX
*XXXX**X**
*X***X*XX*
*XXX*X**XX
*X**XXX**X
*XX***XX*X
*XX*X**X**
